10
E 0 1 0 0 0 0 0 0 0
1 * 1 0 1 1 1 1 1 0
* 0 * * * * * 0 1 0
0 1 1 1 1 1 1 * 1 0
0 1 0 0 0 0 1 0 * 0
0 1 0 1 1 0 1 1 1 *
0 1 0 0 1 0 0 0 1 *
0 0 0 1 1 1 1 0 1 *
1 1 0 0 0 0 0 0 1 *
0 0 0 1 1 1 0 0 0 S

Caminho: (0,0) (1,1) (2,0) (1,1) (2,2) (2,3) (2,4) (2,5) (2,6) (3,7) (4,8) (5,9) (6,9) (7,9) (8,9) (9,9)
